#........................................#
#........................................#
#........................................#
#.@......................................#
#........................................#
#.............G...^^.........F...........#
##########################################
##########################################
##########################################
##########################################
##########################################
win