#.............................................................................................#
#.............................................................................................#
#.@...........................................................................................#
#.............................................................................................#
#........................................###..................................................#
#.............G...^^....................####__.........................................F......#
############################################......#############################################
############################################......#############################################
############################################......#############################################
############################################......#############################################
############################################......#############################################
win