#.............................................................................................#
#..........*........*...........................*....*.......*...........*....................#
#................................................................................*............#
#............*............*..............................*..........*.........................#
#.@..............*....*............................*..........*.............*..........* .....#
#............................W....................................................F...........#
###############################################################################################
###############################################################################################
###############################################################################################
###############################################################################################
###############################################################################################
win