#..................####..#....#.....####..####..####..#.#.#..####..#....#..#..................#
#..................#..#..#....#.....#..#..#..#..#..#..#.#.#..#..#..#...##..#..................#
#..................###...####.#.....#..#..####..#..#..#.#.#..#..#..#..#.#..#..................#
#..................#..#..#..#.#.....#..#..#.....#..#..#.#.#..#..#..#.#..#.....................#
#.@................####..####.#.....#..#..#.....####..#####.##..#..##...#..#..................#
#.................................................................................F...........#
###############################################################################################
###############################################################################################
###############################################################################################
###############################################################################################
###############################################################################################
win