....................
....................
....................
.......@............
................##..
..##..........####..
####################
####################
####################
####################