#..........................................................#
#.........^................................................#
#........<#>...............................................#
#.@.......V...................__...........................#
#..........................................................#
#................##..........____..........................#
#......^^^.....####...................................F....#
###########################........#########################
###########################........#########################
###########################........#########################
###########################........#########################