...........................................................#
...........................................................#
...........................................................#
.@.........................................................#
...........................................................#
................##.........................................#
..##..........####.........................................#
############################################################
############################################################
############################################################
############################################################