....................
....................
....................
.@..................
....................
................##..
..##..........####..
####################
####################
####################
####################