#...........................................................#
#.........^.................................................#
#........<#>................................................#
#.@.......V...................__............................#
#...........................................................#
#................##..........____...........................#
#......^^^.....####.........................................#
###########################........##########################
###########################........##########################
###########################........##########################
###########################........##########################